10 10
1010101011
1111000000
0111100001
1011100110
0001111101
0110101100
0000011100
0101010111
0000000000
1010111010